NO ./textures/north.png
SO ./textures/south.png
WE ./textures/west.png
EA ./textures/east.png

F 120,120,80
C 220,220,255


111111111111111
1     0     0 1
1 111 1 111 1 1
1 1S1   1   1 1
1 1 1111111 1 1
1 0         0
1111111111111
