NO ./textures/north.png
SO ./textures/south.png
WE ./textures/west.png
EA ./textures/east.png

F 100,100,100
C 200,200,255

1111111
1     1
1 0W0 1
1 000
1111111
