NO    	./textures/north_wall.png
SO		./textures/south_wall.png
WE ./textures/west_wall.png
EA        ./textures/east_wall.png

F   90,  60,  30
C   180, 180, 220


111111111111111111111
1     000000000000001
1 111 111111 11111 01
1 1W1       1     0 1
1 1 111 1 111 1 111 1
1 0     1     1     1
111 111111111 111 111
1   1         1     1
1 111 111111111 11111
1     1     1       1
111111111111111111111
