NO ./textures/wall_north.png
SO ./textures/wall_south.png
WE ./textures/wall_west.png
EA ./textures/wall_east.png

F 120,80,40
C 150,200,255

111111
100001
1000N1
100001
111111
