NO ../../textures/scifitextures/wall_desert_0.png
SO ../../textures/scifitextures/wall_desert_1.png
WE ../../textures/scifitextures/wall_desert_2.png
EA ../../textures/scifitextures/wall_ship_0.png

F 1,1,1
C 50,50,50

111111
100001
1000W1
100001
111111
