NO ../../textures/wolftex/bluestone.png
SO ../../textures/wolftex/greystone.png
WE ../../textures/wolftex/eagle.png
EA ../../textures/wolftex/mossy.png

F 120,80,40
C 150,200,255

111111
100001
1000W1
100001
111111
